
l* @ * +     *

r@   @ * - @ +


l* @     @ + -



r- @ - + - * -




l* @ + *  %  -




r- @ -  -  * -